XXXXXXXXXXXXXXXXXXXXX
XS  X X     X   X   X
XXX X X X XXX X X X X
X       X X   X X X X
X XXXXX X X XXXXXXX X
X X   X X   X       X
X XXX X XXX X XXX X X
X     X   X     X X X
X XXXXX XXXXXXXXXXX X
X   X X   X   X     X
XXX X X X X XXXXXXX X
X   X   X X   X   X X
X XXXXXXXXXXX XXX X X
X   X     X         X
XXXXXXX XXX X XXX XXX
X X X X X X X X     X
X X X X X XXX XXX XXX
X   X           X   X
XXX XXX XXX XXX X X X
XE        X   X X X X
XXXXXXXXXXXXXXXXXXXXX