XXXXXXXXXXXXXXXXXXXXXXXXXXXXXXXXXXXXXXXXXXXXXXXXXXXXXXXXXXXXXXXXXXXXXXXXXXXXXXXXXXXXXXXXXXXXXXXXXXXXX
XS    X       X   X     X       X   X X X X             X     X     X     X   X   X X     X         X
XXXXX XXXXX X XXX XXXXX XXXXX XXX X X X X XXXXXXXXXXXXX X X XXX X XXX XXXXX XXXXX X XXX XXX XXX X X X
X X X X X   X X X X         X     X         X         X X X X   X             X           X   X X X X
X X X X XXX XXX X XXXXXXX XXXXX XXX XXX X XXX X X X X X X X XXX XXX XXXXXXXXX XXXXXXX XXXXX X X XXX X
X               X     X   X       X X   X     X X X X     X X     X X       X X X X X X     X X   X X
X X XXX X XXX XXX X XXX XXX XXXXX X X XXXXXXXXX XXXXX XXX X XXXXX XXX XXXXX X X X X X XXXXX XXXXX XXX
X X X   X X X     X X         X X X X X             X X   X   X   X X   X     X X     X X   X X X   X
X XXXXXXX X XXXXXXX XXX XXX X X XXX XXXXXXXXXXXXX X XXX X X X X XXX XXX XXXXX X XXXXX X X XXX X X X X
X X X   X X     X     X X   X   X X   X X     X   X X X X X X X     X     X   X   X X X         X X X
X X X XXXXXXX X XXX X XXXXX XXXXX XXX X X XXX X X X X X XXX XXX XXXXXXX XXXXXXX XXX X X XXX XXX XXX X
X   X         X     X     X     X     X X X   X X X   X   X   X X X                   X   X   X   X X
XXXXXXXXX X XXX XXXXXXXXX X XXX XXXXX X XXX XXXXX XXX X X X X XXX X XXX XXXXXXXXXXX X XXX X X XXXXX X
X   X     X   X       X       X X X           X     X X X X X X   X X   X X X       X   X X X X   X X
XXX X XXX XXX XXXXX X XXXXX XXXXX XXXXXXXXXXX XXXXX X XXXXXXXXXXX XXXXXXX X X XXXXX XXXXXXXXXXX XXX X
X       X X X     X X X     X   X   X             X X       X X X       X X   X X           X X     X
XXX XXXXX X XXX XXXXX XXX XXXXX X XXX X X XXX XXX XXXXX XXX X X XXXXXXX X XXXXX X X XXXXXXXXX XXX X X
X X X       X X X       X X X X   X X X X   X   X X X     X   X         X   X   X X   X X       X X X
X X XXX XXXXX X XXXXXXX XXX X XXX X X XXXXXXXXXXX X X X XXXXXXXXXXXXX XXX XXX XXXXX X X XXX XXX X XXX
X X   X X   X X   X         X   X   X           X   X X   X               X X     X X X X     X     X
X XXXXXXXXX X XXX X X XXX XXX XXX XXX XXX XXXXX X XXXXX X XXXXXXXXXXX X X X XXX X XXX X X X X X XXX X
X   X           X X X   X     X     X X   X X   X X   X X X   X       X X X     X X   X   X X X X   X
XXX X XXX X XXXXXXX XXX X XXX XXX XXXXX XXX XXXXXXXXX XXXXX XXX XXXXXXXXXXXXXXXXX XXX X XXXXXXX XXXXX
X     X   X     X   X X X   X     X X         X X   X           X     X   X X   X     X   X X X X X X
XXXXXXX XXX XXXXXXX X XXX XXX X XXX XXXXXXXXX X X XXXXX XXXXXXXXX XXXXX X X XXX XXX XXX XXX X XXX X X
X X     X X X     X X   X X X X     X   X         X   X X     X   X   X X X   X   X     X       X X X
X XXX X X XXXXXXX XXXXX X X XXX XXX X XXXXX XXX X XXX X XXX XXX X XXX X XXX XXX X X XXX XXXXX XXX X X
X     X   X   X X   X     X   X X   X X X     X X X X   X   X X X X       X X   X     X     X       X
X XXXXXXX XXX X X XXX X XXX XXX XXX X X X XXXXX X X XXX XXX X XXX XXXXX XXX X XXXXXXXXXXX XXX XXXXX X
X     X       X     X X       X X X X       X   X   X       X             X     X       X     X     X
X XXXXXXXXXXX XXXXX XXXXX XXXXXXX X X X X XXX XXX X XXX XXX X X XXXXX X X XXX X XXXXX XXX XXXXXXX X X
X           X X X     X X     X   X X X X X X   X X   X X   X X   X X X X   X X X       X   X   X X X
XXXXX X XXXXX X XXX XXX XXXXX XXX X XXXXX X X X X X X XXX XXXXXXX X XXXXX X XXX XXXXX XXXXX X XXXXX X
X X   X     X X       X       X       X X X X X X X X   X X         X     X X X   X X X X         X X
X X X XXXXX XXX X XXXXXXXXXXXXXXX XXXXX X X XXXXX XXX XXX X XXX XXXXXXXXXXXXX X XXX X X X XXX X XXXXX
X   X X X X   X X   X   X     X   X   X     X   X X     X   X         X   X       X X     X   X X   X
XXX X X X XXXXX XXX X XXXXXXX XXXXX X XXXXX X XXX XXX XXX XXX XXXXXXX X XXXXX X XXX X X XXX X XXX XXX
X   X X           X X     X X       X X       X   X       X   X     X   X X   X X   X X   X X X X   X
X XXX X XXXXXXX X XXX XXXXX XXX X XXX XXX XXX XXXXXXXXX X XXXXXXX X XXX X X XXXXX X XXX XXXXX X XXX X
X   X     X   X X         X     X X     X   X     X     X     X   X   X   X   X   X X     X         X
X X X XXX X XXXXXXXXXXXXXXXXXXX XXXXX X X XXXXXXXXXXXXXXX XXXXX X XXXXX XXX X X XXXXX X XXX XXX XXX X
X X X   X       X X   X X X       X   X               X X X X   X X X   X   X   X   X X X   X X   X X
XXX XXXXXXXXXXX X X XXX X X XXX XXXXX X X XXX XXXXX XXX X X XXX XXX XXXXX XXXXX X XXXXXXX XXX X XXXXX
X   X     X       X X     X X       X X X X       X     X   X     X       X X   X X           X X   X
X XXXXXXX XXX X XXX XXX XXXXXXXXX XXXXX XXXXX X X XXXXXXX XXXXX XXXXX X XXX XXX X XXXXX XXX XXXXXXX X
X         X   X               X   X X       X X X     X         X     X X   X       X X X   X       X
X X X XXX XXX X XXX XXXXXXXXXXXXX X X XXXXX X XXXXXXXXX XXX X X XXXXX XXXXX X XXXXX X X XXXXX X XXXXX
X X X X   X X X X X   X X     X     X     X X   X X X X X X X X         X     X       X X   X X     X
XXXXX XXXXX X X X XXXXX X X XXX X X XXXXX XXX X X X X XXX XXX XXX X XXXXX X XXX XXXXX XXXXX XXX XXXXX
X   X     X   X X     X X X   X X X X     X   X       X     X X   X X     X X   X X X X     X       X
X XXX XXXXXXXXX X XXX X XXX XXXXXXXXXXXXXXXXXXX X X XXX X X XXX XXXXXXXXXXX X XXX X X X X XXXXX XXX X
X X X X X X       X           X   X   X   X   X X X   X X X   X     X     X X X   X X X X X   X X   X
X X XXX X XXXXX X XXX XXXXXXXXXXX XXX X XXXXX XXX XXXXX X X XXXXX XXX XXXXX X X XXX X X X X XXX XXX X
X X   X     X   X X X   X X X X   X       X X X X   X   X X         X X X   X X   X     X X       X X
X X X XXX X XXX X X XXX X X X X X X XXXXX X X X X XXXXX XXX X XXXXX X X XXXXXXXXX X XXX XXX XXXXXXXXX
X   X   X X X X X     X     X X X     X           X     X   X X             X X       X X           X
X XXXXX X XXX X X XXXXXXX X X X XXX XXXXXXX XXXXX XXX X X XXXXXXXXXXX XXXXX X X X XXX X XXX X X XXX X
X X X   X X X   X     X   X   X   X X       X X X X X X X X           X   X   X X   X X X X X X X   X
X X XXX X X XXX X XXXXX X X XXX XXXXXXX X XXX X X X XXXXX XXXXX XXXXX X XXXXXXX XXXXX X X X XXXXXXX X
X X             X X     X X           X X       X   X         X     X     X         X X       XE    X
XXXXXXXXXXXXXXXXXXXXXXXXXXXXXXXXXXXXXXXXXXXXXXXXXXXXXXXXXXXXXXXXXXXXXXXXXXXXXXXXXXXXXXXXXXXXXXXXXXXXX